
SO         ./textures/SO.png
WE                              ./textures/WE.png
F        123,      255          , 0
C               1   , 225, 23
EA ./textures/EA.png
NO              ./textures/NO.png






        111111111111111111111111
        11111111111111111111111111
        100000000110000000000001
        1011000001110000000000001
        1101000000010000000000001
 111111110110000011100000000001
  10000000001100000111111111111111
 11110111111111011100000010001
11110111111111E11101010010001
11000000110101011100000010001
10000000000000001100000010001
1000000000000000110101001001
 110000011101010111110111100111
11110111  1110101 101111010001
 111111   1111111 11   1111111111