NO ./textures/NO.png
WE ./textures/WE.png
SO ./textures/SO.png
EA ./textures/EA.png

F 50,50,50
C 225,30,0

1111111111111111  111
1001000000001   11 0 1
1000011111001111  111
1000110000001
1011111111111
101
101
101
101
101
101
101                                  11011
101111111111111111111111111111111111110001
101                                  11111
101
101
101
101
101
1N1
1 1
1 1
