SO         ./textures/qSO.png
WE                              ./textures/qWE.png
C        207         ,    190             ,                   62
F   62               ,      110       , 207      
EA ./textures/qEA.png
NO              ./textures/qNO.png

        111111111111111111111111
        11111111111111111111111111
        100000000110000000000001
        1011000001110000000000001
        110100000001000000000001
 1111111101100000111000000000011
  10000000001100000111111111111111
 11110111111111011100000010001
11110111111111111101010010001
11000000110101011100000010001
10000000S0000000110000000001
1000000000000000000001001001
 110000011101010111110111100111
11110111  1110101 101111010001
 111111   1111111 11   1111111111