

NO ./textures/NO.png
WE ./textures/WE.png
SO ./textures/SO.png
EA ./textures/EA.png

C 0,           5, 5
F 50,     -5,     50


111111111111111111
   111001000000001
111100000000011111
100001111100111
100011E000001
1111111111111
