NO ./textures/NO.png
WE ./textures/WE.png
SO ./textures/SO.png
EA ./textures/EA.png

F 50,50,50
C 0,-1,200

1111111111111
1001000000001
1000011111001
100011E000001
1111111111111
