11111111111111111111111111111111
10000000000000001000001000000000111
11111000000000001000001000000001
10000100000000001000001000000001
10001000000000000000000000000001
10111000000000000000000000000001
10111000000000000000110000000001
10000100000000000001000000000001
100000000E0000110001000000000001
11111111111111111111111111111111
