F 50,50,50
NO ./textures/NO.png

WE ./textures/WE.png
SO ./textures/SO.png


EA ./textures/EA.png







C 225,30,0
1111111111111111111
10010000000011101
1000011111001111111
1000110000001
1011111111111
101
101
101
101
101
101
101                                  11111
101111111111111111111111111111111111110001
101                                  11111
101
101
101
101
1N1
101
1 1
1 1
