F 50,50,50
C 225,30,0


NO ./textures/NO.png
WE ./textures/WE.png
SO ./textures/SO.png
EA ./textures/EA.png

  111111111111111111111
 1000000000000000000001
 011100000000000000111
 10000000000000000001
  11000000000000000001
   10000E0000000000001
   1000000000000000001
   1000000000000001111
   1000000101010000001
   1111111111111111111
